..........
...###....
#.G..##...
.#..###...
.##...###.
...##....S
