10 35
..........
....##....
..........
L..L....LL
...L......
..........
L....L..L.
.L......L.
....LL....
....LL....
..L.......
..L.....LL
..........
L.....L...
LL....L...
LL....L...
..........
....G.....
##########
..........
..........
..........
..........
..........
..........
..........
..........
..........
..........
..........
..........
..........
..........
..........
..........
