20 15
....................
....................
....................
....................
..........G.........
.......####.........
..##................
....................
....##..............
........####........
....................
...######...#####...
....................
....................
LLLLLLLLLLLLLLLLLLLL
