40 10
........................................
........................................
.......#######..........................
................##......................
..##.................................G..
......................##.............#..
......####..................###.........
####...............##.............#.....
........................................
LLLLLLLLLLLLLLLLLLLLLLLLLLLLLLLLLLLLLLLL
